##########
# ##   # #
#    #   #
####   ###
# ### ## #
# #   #  #
#   #   ##
# ### ## #
#   #    #
# ########
